5800
SSSWWWWW
SWSWWWWW
SWSWWWWW
GWSSSSSS
SSSWWWWW
