9800
SWSWWWWW
SWSWWWWW
SWSWWWWW
SWSWWWWW
SWSWWWWW
SWSWWWWW
SWSWWWWW
GWSSSSSS
SSSWWWWW
